111111111111
10000E0P0001
10CCC00C0001
111111111111